Igniter – зажигалка
Slender – стройный
Pedestrian – пешеход
Trembling – дрожащий
Featureless – безликий
Peculiar – своеобразный
Hound – гончая (собака)
Morphine – морфин
Ventilator – вентиляционная решётка
Craftsmanship – мастерство
Chestnuts – каштаны
Knitting – вязание
Conscience – совесть
Spectacle – зрелище
Condemnation – осуждение
Porch – крыльцо
Contempt – презрение
Startled – пораженный, удивленный
Abyss – бездна
Ravenous – жадный, алчный
Frowning – хмурый
Dandelion – одуванчик
Censorship – цензура
Serenity – спокойствие
Heritage – наследие
Heredity – наследственность
Subconscious – подсознание
Dare-devils – сорвиголовы
Embarrassing – неловкий
Limp – вялый

Arouse – пробуждать, возбуждать
Parcel – посылка, сверток
Appendage – придаток, дополнительная часть
Stomp – топать, топтать
Chortle – хихикать, фыркать от смеха
Swoop – налетать, бросаться вниз
Crate – ящик, контейнер
Flutter – трепетать, дрожать, махать (крыльями)
Askew – криво, косо
Uproar – шум, гам
Rumble – громыхать, грохотать
Jostle – толкать, теснить
Shove – пихать, толкать
Hiss – шипеть
Dull – скучный, тупой (в значении предмета или ума)
Mangle – калечить, искажать
